XXXXXXXXXXX XXXXXXXXXXXXXXX
XXXXXXXXXXX XXXXXXXXXXXXXXX
XXXXXXXXXXX XXXXXXXXXXXXXXX
XXXXXXXXXXX XXXXXXXXXXXXXXX
XXXXXXX   X XXXXXXXXXXXXXXX
XXXXXXX XXXXXXXXXXXXXXXXXXX
XXXXXXX                   X
XXXXXXXXXXXXXXXXXXXXXXXXX X
XXXXXXXXXXXXXXXXXXXXX     X
XXXXXXXXXXXXXXXXXXXXX XXXXX
XXXXXXXXXXXXXX        XXXXX
XXXXXXXXXXXXXX XXXXXXXXXXXX
XXX            XXXXXXXXXXXX
XXX XXXXXX XXXXXXXXXXXXXXXX
XXX XXXXXX XXXXXXXXXXXXXXXX
XXX                XXXXXXXX
XXXXXXXXXXXXXXXXXX XXXXXXXX
XXXXXXXXXXXXXXXXXX XXXXXXXX
XXXXXXXXXXXX       XXXXXXXX
XXXXXXXXXXXX XXXXXXXXXXXXXX
XXXXXXXXXXXX XXXXXXXXXXXXXX
XXXXXXXXXXX   XXXXXXXXXXXXX
XXXXXXXXXXX S XXXXXXXXXXXXX
XXXXXXXXXXX   XXXXXXXXXXXXX