XXXXXXXXXXX   XXXXXXXXXXXXXXXXXX
XXXXXXXXXXX   XXXXXXXXXXXXXXXXXX
XXXXXXXXXXX XXXXXXXXXXXXXXXXXXXX
XXXXXXXXXXX XXXXXXXXXXXXXXXXXXXX
XXXXXXX     XXXXXXXXXXXXXXXXXXXX
XXXXXXX XXXXXXXXXXXXXXXXXXXXXXXX
XXXXXXX                   XXXXXX
XXXXXXXXXXXXXXXXXXXXXXXXX XXXXXX
XXXXXXXXXXXXXXXXXXXXX     XXXXXX
XXXXXXXXXXXXXXXXXXXXX XXXXXXXXXX
XXXXXXXXXXXXXX         XXXXXXXXX
XXXXXXXXXXXXXX XXXXXXX XXXXXXXXX
XXX            XXXXXXX XXXXXXXXX
XXX XXXXXX XXXXXXXXXXX XXXXXXXXX
XXX XXXXXX XXXXXXXXXXX XXXXXXXXX
XXX                    XXXXXXXXX
XXXXXXXXXXXXXXXXXX XXXXXXXXXXXXX
XXXXXXXXXXXXXXXXXX XXXXXXXXXXXXX
XXXXXXXXXXXX       XXXXXXXXXXXXX
XXXXXXXXXXXX XXXXXXXXXXXXXXXXXXX
XXXXXXXXXXXX XXXXXXXXXXXXXXXXXXX
XXXXXXXXXXX   XXXXXXXXXXXXXXXXXX
XXXXXXXXXXX   XXXXXXXXXXXXXXXXXX
XXXXXXXXXXX   XXXXXXXXXXXXXXXXXX
XXXXXXXXXXX   XXXXXXXXXXXXXXXXXX
XXXXXXXXXXX   XXXXXXXXXXXXXXXXXX
XXXXXXXXXXX   XXXXXXXXXXXXXXXXXX
XXXXXXXXXXX   XXXXXXXXXXXXXXXXXX
XXXXXXXXXXXX XXXXXXXXXXXXXXXXXXX
XXXXXXXXXXXX XXXXXXXXXXXXXXXXXXX
XXXXXXXXXXXXSXXXXXXXXXXXXXXXXXXX
XXXXXXXXXXXXXXXXXXXXXXXXXXXXXXXX